1111111
1P0EC11
1P0EC11
1P0EC11
1111111