111111111111111111111111111111111
1000000000000000P000C0000E0000M01
111111111111111111111111111111111